25 20
########     #########
#X.....#     #......k#
######d#######cc.#####
#h#.......ff.......cc#
#...ff....l........###
#################..#
#################e.#####
#........s....cc......c#
#...cc.....q.........cc#
#..#####################
#..#
#..###### ##############
#....s..###h.........ff#
#...g........##...q...f#
#...ff..#....#.........#
##e################..###
 #.#              #..#
 #d#       ########..##
 #t#       #..@......f#
 ###       ############