25 20
########################
#X.....#h.....l.....d..#
#####e##....ccc.....#s.#
#cc....#....ch.s....#.f#
#ts.......q.........#.f#
#####################..#
                    #..#
#####################..#
#.e...fff......ff......#
#.#...f..s..#.....s....#
#k#.........##........f#
##########..#cc..s...ff#
#...........#c........h#
#.######################
#.#
#.######################
#...q....ff..f....#..@.#
#s.......f.q..ff..#....#
#.....l................#
########################